4 4 4 4 4 4 4 7 4 4 4 4 4 4 4 4 4 4 4 4 4 4 4 4 4 4 4 4 4 4 4 4 4 4 4 4 4 4 4 4 4 4 4 4 4 4 4 4 4 4
4 4 4 4 4 6 4 4 4 4 4 4 4 4 4 4 4 6 4 4 4 4 4 4 4 4 4 4 4 6 4 4 6 4 4 4 4 4 4 4 4 4 4 4 6 4 4 4 4 4
4 4 4 4 7 4 4 4 4 7 4 4 4 4 7 4 4 4 4 4 0 2 2 2 2 2 0 4 4 4 4 4 4 6 4 4 4 4 4 4 4 4 4 4 4 4 4 4 4 4
4 6 4 4 6 4 4 4 4 6 4 6 4 4 4 4 6 4 4 4 2 2 2 2 2 2 2 4 4 7 4 4 4 4 4 4 6 4 4 4 4 4 4 4 4 4 4 4 4 4
4 4 4 4 4 4 4 4 4 4 4 4 4 4 4 6 4 4 4 4 2 2 2 2 2 2 2 4 4 4 4 4 4 4 6 4 4 4 4 6 4 4 4 6 4 4 4 4 4 4
4 4 4 4 4 4 4 4 4 4 4 4 4 4 4 4 4 4 4 4 2 2 2 2 2 2 2 4 4 6 4 4 4 4 4 4 6 4 4 4 4 4 4 4 4 4 7 4 4 4
4 6 4 4 6 4 4 4 7 7 7 7 7 4 4 4 6 4 4 4 4 2 2 2 2 2 4 4 4 4 4 4 4 4 4 4 4 4 4 4 4 4 4 4 4 4 4 4 4 4
4 4 4 4 4 4 4 4 7 3 3 3 7 4 6 4 4 4 6 4 0 0 0 0 0 0 0 4 4 4 4 4 4 0 5 5 5 5 5 5 5 4 4 4 4 4 4 4 4 4
4 6 4 4 6 4 4 4 7 3 3 3 7 4 4 7 4 4 4 4 4 0 0 0 0 0 4 4 4 6 4 4 4 4 5 5 5 5 5 5 5 5 4 4 6 4 4 4 4 4
4 4 4 4 4 4 4 4 7 3 3 3 7 4 4 4 4 6 4 4 4 4 0 0 0 4 4 4 4 4 7 4 4 4 5 5 5 5 5 5 5 5 4 4 4 7 4 4 4 4
4 4 4 4 4 4 6 4 7 3 3 3 7 4 6 4 4 4 4 4 4 4 4 5 4 4 4 6 4 4 4 6 4 4 5 5 5 5 5 5 5 5 4 4 4 4 4 4 4 4
4 6 4 6 4 4 4 4 7 7 0 7 7 4 4 4 4 4 6 4 4 4 4 5 4 4 4 4 4 4 4 4 4 4 5 5 5 5 5 5 5 5 4 6 4 4 4 4 4 4
4 4 4 4 4 4 4 4 4 4 0 4 4 4 4 4 6 4 4 4 4 4 4 5 4 4 4 6 4 7 4 4 4 4 4 5 5 5 5 5 5 4 4 4 4 7 4 6 4 4
4 4 4 6 4 4 7 4 4 4 0 4 4 4 6 4 4 4 6 4 4 4 4 5 4 4 4 4 4 4 6 4 4 4 4 4 4 4 5 4 4 4 4 4 4 4 4 4 4 4
4 4 4 4 4 4 4 4 4 4 0 4 4 6 4 6 4 6 4 4 4 4 4 5 4 4 6 4 4 4 4 4 4 4 4 4 6 4 5 4 4 4 4 4 4 4 4 4 4 4
4 4 4 6 4 4 4 4 4 4 0 4 7 4 6 4 4 4 6 4 4 4 4 5 4 6 4 4 4 7 4 4 4 4 7 4 4 4 5 4 4 4 4 4 4 4 4 4 4 4
4 4 4 4 4 4 4 4 0 0 0 4 4 4 4 4 4 4 4 4 4 4 4 5 4 4 4 6 4 4 4 6 4 4 4 4 4 4 5 4 6 4 4 4 4 7 4 4 4 4
4 4 6 4 6 4 4 4 0 4 4 7 4 4 6 4 4 4 4 4 4 4 4 5 4 4 4 4 4 4 4 4 4 4 4 4 4 4 5 4 4 4 4 6 4 4 4 6 4 4
4 4 4 4 6 4 4 4 0 4 4 4 4 4 4 4 4 4 4 4 4 4 0 5 0 4 4 4 7 4 6 4 4 4 4 4 5 5 5 4 4 4 4 4 4 4 4 4 4 4
4 7 4 4 4 4 4 4 0 4 4 4 4 4 4 6 4 4 6 4 4 0 0 5 0 0 4 4 4 4 4 7 4 4 4 4 5 4 4 4 4 4 4 4 4 4 4 4 4 4
4 4 4 4 4 4 4 4 0 4 4 4 4 4 4 4 4 4 4 4 0 0 0 5 0 0 0 4 4 4 4 4 4 4 4 5 5 4 4 4 4 4 7 4 4 4 4 4 4 4
4 4 6 4 4 6 4 4 0 4 4 4 5 5 5 5 5 5 5 5 5 5 5 5 5 5 5 5 5 5 5 5 5 5 5 5 5 4 6 4 4 4 4 4 4 4 6 4 4 4
4 4 4 4 4 4 4 4 0 4 6 4 0 4 4 4 4 4 4 4 0 0 0 5 0 0 0 4 4 4 4 4 4 4 4 4 5 4 4 4 4 4 4 4 4 4 4 4 4 4
4 4 6 4 4 4 4 4 0 4 4 4 0 4 4 4 7 4 4 4 4 0 0 5 0 0 4 6 4 4 7 4 4 4 4 4 5 4 4 4 7 4 4 4 4 6 4 4 4 4
4 4 4 4 4 4 4 4 0 4 4 4 0 4 4 6 4 4 6 4 4 4 0 5 0 4 4 4 6 4 4 4 4 6 4 4 5 4 4 4 4 4 4 4 4 4 4 4 4 4
4 4 6 4 4 4 4 4 0 6 4 4 0 0 0 4 4 4 4 4 4 4 4 5 4 6 4 4 4 4 4 4 4 4 4 4 5 4 4 4 4 7 4 4 4 4 4 4 4 4
4 4 4 4 4 4 4 4 0 4 4 4 4 4 0 4 4 4 6 4 4 4 4 5 4 4 4 4 4 4 4 4 4 4 4 4 5 4 4 4 4 4 4 4 4 4 4 4 4 4
4 4 4 4 4 4 4 4 0 4 4 4 4 4 0 4 6 4 4 4 4 4 4 5 4 4 4 0 4 4 4 6 4 4 4 0 5 4 4 6 4 4 4 4 4 4 4 4 4 4
4 4 4 4 4 4 4 4 0 4 4 4 4 4 0 4 4 4 6 4 4 4 4 5 4 4 4 4 4 4 0 4 4 4 4 4 5 4 4 4 4 7 4 4 4 4 4 4 4 4
4 4 4 4 4 4 4 4 0 0 0 0 0 0 0 4 4 4 4 4 4 4 4 5 4 4 4 4 4 4 0 4 4 4 4 4 5 4 4 4 4 6 4 4 4 4 6 4 4 4
4 4 4 7 4 4 6 4 0 0 0 0 0 0 0 4 6 4 4 6 4 4 4 5 4 6 4 4 7 4 6 4 4 4 4 4 0 4 4 4 4 4 4 4 4 4 4 4 4 4
4 4 4 4 6 4 4 4 0 0 0 0 0 0 0 4 4 4 6 4 4 4 4 5 4 4 6 4 4 4 4 4 4 4 4 0 0 0 4 4 4 4 4 4 4 4 4 4 4 4
4 4 4 4 4 4 4 4 0 0 0 0 0 0 0 4 4 4 4 4 4 4 4 5 4 4 4 4 6 4 4 6 4 4 4 0 0 0 4 4 4 4 6 4 6 6 4 4 4 4
4 6 4 4 4 4 4 4 0 0 0 0 0 0 0 4 6 4 4 4 4 4 4 5 4 4 4 4 4 4 4 4 4 4 4 0 0 0 4 4 6 4 4 6 4 4 4 4 4 4
4 4 4 4 4 4 4 4 0 0 0 0 0 0 0 4 4 4 4 4 6 4 4 5 4 4 4 4 4 4 4 4 4 4 4 0 0 0 4 4 4 4 4 4 4 4 4 4 4 4
4 4 4 6 4 4 4 4 4 4 6 4 4 4 4 4 4 4 4 4 4 4 4 5 4 4 4 4 4 4 4 4 4 4 4 0 0 0 4 4 4 4 4 4 4 4 4 4 4 4
4 4 4 4 4 4 4 4 4 4 4 4 4 4 4 4 4 4 4 0 0 0 0 0 0 0 0 4 4 4 4 4 4 4 0 0 0 0 0 4 4 4 4 4 4 4 4 4 4 4 
4 4 4 6 4 4 6 4 4 4 4 4 4 4 6 4 6 4 0 0 0 0 0 0 0 0 0 0 4 4 0 4 4 0 0 0 0 0 0 4 4 4 4 4 4 4 4 4 4 4
4 4 4 4 6 4 4 4 4 4 4 4 4 6 4 4 4 4 0 0 0 0 0 0 0 0 0 0 4 4 4 4 0 0 0 0 0 0 0 4 4 4 4 4 4 4 4 4 4 4
4 4 4 4 4 4 4 4 4 4 6 4 4 0 6 4 4 4 0 0 0 0 0 0 0 0 0 0 0 4 4 4 0 0 0 0 0 6 0 4 6 4 4 4 7 4 4 4 4 4
4 4 6 4 6 4 4 4 4 4 4 4 4 4 4 4 4 4 0 0 0 0 0 0 0 0 0 0 0 0 0 0 0 0 4 0 0 0 0 4 4 4 4 4 4 4 4 4 4 4
4 4 4 4 4 4 4 4 6 4 4 4 4 0 4 4 4 4 4 0 0 0 0 0 0 0 0 4 4 4 4 0 0 0 0 0 0 0 0 4 4 4 4 4 4 4 4 4 4 4
4 4 6 4 4 4 7 4 4 4 4 4 4 4 4 4 4 4 4 4 0 0 0 0 0 0 4 6 4 6 4 0 0 4 0 0 4 0 0 4 4 6 4 6 4 4 4 4 4 4
4 4 4 4 4 4 4 4 4 4 4 4 4 4 4 4 4 4 4 4 4 4 4 4 4 4 4 4 4 4 4 4 0 0 0 0 0 0 4 4 4 4 4 4 7 4 4 4 4 4
4 4 4 4 4 4 4 6 4 4 4 6 4 4 4 7 4 4 4 4 4 4 4 6 4 6 4 4 7 4 4 4 4 4 4 4 4 4 4 4 4 4 4 4 4 4 4 4 4 4
4 4 6 4 4 4 4 4 4 4 4 4 4 4 4 4 4 4 7 4 4 4 4 4 4 4 4 4 4 4 4 4 4 4 4 4 4 4 4 4 4 4 4 4 4 6 4 4 6 4
4 4 4 6 4 4 6 4 4 4 4 4 6 4 4 4 4 4 4 4 4 4 4 6 4 4 4 4 7 4 4 4 4 6 4 4 4 4 4 4 4 4 4 4 4 4 4 4 4 4
4 6 4 4 6 4 4 4 4 4 4 4 4 4 6 4 4 4 4 6 4 4 4 4 4 4 4 4 4 4 6 4 4 4 4 6 4 4 4 4 4 7 4 4 4 6 4 4 4 4
4 4 4 4 4 6 4 4 7 4 4 4 6 4 4 4 4 6 4 4 4 6 4 4 4 4 4 4 4 4 4 4 4 4 4 4 4 4 4 4 4 4 4 4 4 4 4 4 4 4
4 4 4 4 4 4 4 4 4 4 4 4 4 4 4 4 4 4 4 4 4 4 4 4 4 4 4 4 4 4 4 4 4 4 4 4 4 4 4 4 4 4 4 4 4 4 4 4 4 4 